11111111111111111111111111
1C11E1P0011101000101111C11
10110111010001101101100011
1001C0000001111C1100000111
11000011110000000101110111
111111C00001111100011C00C1
11111111111111111111111111
