111111111111111111111111111111111111111111111111111111111111111
100000000000000C00000000000000000000000000000000000000000000001
101001010010000011010010100101001010010010100101001001010010101
101001001010101001010010100101001010010010100101001001010010101
100000000C00C0000000C0000C0000C0000C00C0000C0000C00C0000C0000C1
100000000000000C00000000000000000000000000000000000000000000001
101001010010000011010010100101001010010010100101001001010010101
101001001010101001010010100101001010010010100101001001010010101
100000000C00C0000000C0000C0000C0000C00C0000C0000C00C0000C0000C1
100000000C00C0000000C0000C0000C0000C00C0000C0000C00C0000C0000C1
100000000000000C00000000000000000000000000000000000000000000001
101001010010000011010010100101001010010010100101001001010010101
101001001010101001010010100101001010010010100101001001010010101
100000000C00C0000000C0000C0000C0000C00C0000C0000C00C0000C0000C1
100000000000000C00000000000000000000000000000000000000000000001
101001010010000011010010100101001010010010100101001001010010101
101001001010101001010010100101001010010010100101001001010010101
100000000C00C0000000C0000C0000C0000C00C0000C0000C00C0000C0000C0
100000000000000C00000000000000000000000000000000000000000000001
101001010010000011010010100101001010010010100101001001010010101
101001001010101001010010100101001010010010100101001001010010101
100000000C00C0000000C0000C0000C0000C00C0000C0000C00C0000C0000C1
100000000C00C0000000C0000C0000C0000C00C0000C0000C00C0000C0000C1
100000000000000C00000000000000000000000000000000000000000000001
101001010010000011010010100101001010010010100101001001010010101
101001001010101001010010100101001010010010100101001001010010101
100000000C00C0000000C0000C0000C0000C00C0000C0000C00C0000C0000C1
111111111111111111111111111111111111111111111111111111111111111
