111111111111111111111111111111111111111111111111111111111111111
100000000000000100000000000000000000000000000000000000000000001
101001010010000011010010100101001010010010100101001001010010101
101001001010101001010010100101001010010010100101001001010010101
100000000100100000001000010000100001001000010000100100001000011
100000000000000100000000000000000000000000000000000000000000001
1010010100100000110100101001010010100100101001010E1001010010101
101001001010101001010010100101001010010010100101001001010010101
1000000001001000000010000100001000010010000100C0100100001000011
100000000100100000001000010000100001001000010000100100001000011
100000000000000100000000000000000000000000000000000000000000001
101001010010000011010010100101001010010010100101001001010010101
101001001010101001010010100101001010010010100101001001010010101
100000000100100000001000010000100001001000010000100100001000011
100000000000000100000000000000000000000000000000000000000000001
101001010010000011010010100101001010010010100101001001010010101
101001001010101001010010100101001010010010100101001001010010101
100000000100100000001000010000100001001000010000100100001000010
100000000000000100000000000000000000000000000000000000000000001
101001010010000011010010100101001010010010100101001001010010101
101001001010101001010010100101001010010010100101001001010010101
100000000100100000001000010000100001001000010000100100001000011
100000000100100000001000010000100001001000010000100100001000011
100000000000000100000000000000000000000000000000000000000000001
101001010010000011010010100101001010010010100101001001010010101
101001001010101001010010100101001010010010100101001001010010101
100000000100100000001000010000100001001000010000100100001000011
111111111111111111111111111111111111111111111111111111111111111
