111111111111111111111111111111111111111111111111111111111111
1CC000100010000000001000000000000000000000000000000000000001
11100010001000C000001000000000000000000000000000000000000001
100000100010000000001000001111111111000000000000000000000001
100100100010000000001000000000000000000000000000000000000001
100100100010000000001000000000000011111111110000000000000001
1001001000100000E0101000000000000000000000000000000000000001
100100100010000000000000000000000000000000000000000000000001
1001000C0000000000000000000000000000000000000000000000000001
100100000000000000000000001111111111111111000001111111111111
100101000000010000000000000000000000000000000000000000000001
100001000000010000000000000000000000000001111111111111111001
100001000000010000000000011111111111111110000000000000000001
100001000000010000000000000000000000000000000000000000000001
100001000000010000000000000000000000000000000000000000000001
100001000C00010000000000000000000000111111111111111100000001
1000010000000100PC000000000000000000000000000000000000000001
100001000000010000000000000000000000000000111111111100000001
100001000000010000000000111111111111111100000000000000000001
100001000000010000000000000000000000000000000000000000000001
100001000000010000000000000000000000000000000000000000000001
100001000000010000000000111111111100000000000000000000000001
100001000000010000000000000000000000000000000000000000000001
100001000000010000000000000000000000001111111111111111000001
100001000000010000000000000000000000000000000000000000000001
100001000000010000011111111111111110000000000000000000000001
100001000000010000000000000000000000000000000000000000000001
100001000000010000000000000011111111110000000000000000000001
100001000000010000000000000000000000000000000000000000000001
100001000000010000000000000000000000000000000000000000000001
100001000000010000000001111111111111111000000000000000000001
100001000000010000000000000000000000000000000000000000000001
111111111111111111111111111111111111111111111111111111111111
